"lang"
{
"Language"	"spanish"
"Tokens"
{
"addon_game_name"	"La ira de los Mo'rokai"
"[english]addon_game_name"	"Wrath of the Mo'rokai"
"DOTA_Tooltip_ability_item_bag_of_gold"	"Saco de Oro"
"[english]DOTA_Tooltip_ability_item_bag_of_gold"	"Bag of Gold"
"DOTA_GameMode_15"	"La ira de los Mo'rokai"
"[english]DOTA_GameMode_15"	"Wrath of the Mo'rokai"
"DOTA_GameMode_19"	"La ira de los Mo'rokai"
"[english]DOTA_GameMode_19"	"Wrath of the Mo'rokai"
"npc_dota_creature_jungle_spirit"	"Mo'rokai"
"[english]npc_dota_creature_jungle_spirit"	"Mo'rokai"
"npc_dota_jungle_spirit_summon_1"	"Espíritu Guerrero"
"[english]npc_dota_jungle_spirit_summon_1"	"Spirit Warrior"
"npc_dota_jungle_spirit_summon_2"	"Espíritu Guardián"
"[english]npc_dota_jungle_spirit_summon_2"	"Spirit Guardian"
"npc_dota_gem_pinata"	"Tesoro de Esencia"
"[english]npc_dota_gem_pinata"	"Essence Treasure"
"npc_battle_point_pinata"	"Tesoro Raro"
"[english]npc_battle_point_pinata"	"Rare Treasure"
"DOTA_Tooltip_ability_item_spirit_gem"	"Esencia"
"[english]DOTA_Tooltip_ability_item_spirit_gem"	"Essence"
"MorokaiMarchTimer"	"EL MO'ROKAI {s:next_march_team} MARCHA POR LA {s:march_lane}"
"[english]MorokaiMarchTimer"	"{s:next_march_team} MO'ROKAI MARCHING {s:march_lane}"
"JungleSpirits_Tooltip_View_Branches"	"Ver el árbol de habilidades del Mo'rokai"
"[english]JungleSpirits_Tooltip_View_Branches"	"View Mo'rokai Path Abilities"
"hud_error_not_enough_gems"	"No hay suficiente esencia"
"[english]hud_error_not_enough_gems"	"Not Enough Essence"
"hud_error_took_damage_recently"	"No se puede gastar Esencia - Daño reciente del jugador"
"[english]hud_error_took_damage_recently"	"Cannot Spend Essence - Recent Player Damage"
"hud_error_cooldown_not_ready"	"No se puede gastar Esencia - Actualizar en el tiempo de recarga"
"[english]hud_error_cooldown_not_ready"	"Cannot Spend Essence - Upgrade On Cooldown"
"hud_error_spirit_is_active"	"No se puede gastar Esencia - El espiritu está activo"
"[english]hud_error_spirit_is_active"	"Cannot Spend Essence - Spirit is Active"
"jungle_branch_cost"	"Espíritu"
"[english]jungle_branch_cost"	"Spirit"
"storm_branch_cost"	"Tormenta"
"[english]storm_branch_cost"	"Storm"
"volcano_branch_cost"	"Ira"
"[english]volcano_branch_cost"	"Wrath"
"spirit_branch"	"Espíritu"
"[english]spirit_branch"	"Spirit"
"wrath_branch"	"Ira"
"[english]wrath_branch"	"Wrath"
"storm_branch"	"Tormenta"
"[english]storm_branch"	"Storm"
"JungleSpirits_NewMarchRadiant"	"¡El <panel class='MorokaiIcon'/><font color='#27E100'>Mo'rokai Radiant</font> avanza por la senda {s:locstring_value}!"
"[english]JungleSpirits_NewMarchRadiant"	"<panel class='MorokaiIcon'/><font color='#27E100'>Radiant Mo'rokai</font> is charging down {s:locstring_value} lane!"
"JungleSpirits_NewMarchDire"	"¡El <panel class='MorokaiIcon'/><font color='#ff4d4d'>Mo'rokai Dire</font> avanza por la senda {s:locstring_value}!"
"[english]JungleSpirits_NewMarchDire"	"<panel class='MorokaiIcon'/><font color='#ff4d4d'>Dire Mo'rokai</font> is charging down {s:locstring_value} lane!"
"JungleSpirits_GemWarning"	"<panel class='MorokaiEssenceWarningIcon'/>Un tesoro de <font color='#06FFFF'>esencia</font> está a punto de aparecer."
"[english]JungleSpirits_GemWarning"	"<panel class='MorokaiEssenceWarningIcon'/>An <font color='#06FFFF'>essence</font> treasure is about to spawn."
"JungleSpirits_BattlePointsPackageWarning"	"<panel class='MorokaiEssenceWarningRareIcon'/>Un tesoro <font color='#FF55FF'>raro</font> está a punto de aparecer."
"[english]JungleSpirits_BattlePointsPackageWarning"	"<panel class='MorokaiEssenceWarningRareIcon'/>A <font color='#FF55FF'>rare</font> treasure is about to spawn."
"JungleSpirits_CreatureGainedLevel"	"¡<panel class='MorokaiIcon'/>Tu Mo'rokai ha obtenido el <font color='#668cff'>nivel {s:locstring_value}</font>!"
"[english]JungleSpirits_CreatureGainedLevel"	"<panel class='MorokaiIcon'/>Your Mo'rokai gained <font color='#668cff'>level {s:locstring_value}</font>!"
"GameEvent_PlayerOpenedCarePackage"	"¡{s:player_name} ha abierto un tesoro de <font color='#06FFFF'>esencia</font>!"
"[english]GameEvent_PlayerOpenedCarePackage"	"{s:player_name} opened an <font color='#06FFFF'>essence</font> treasure!"
"GameEvent_PlayerOpenedLargeCarePackage"	"¡{s:player_name} ha abierto un tesoro <font color='#FF55FF'>raro</font>!"
"[english]GameEvent_PlayerOpenedLargeCarePackage"	"{s:player_name} opened a <font color='#FF55FF'>rare</font> treasure!"
"GameEvent_PlayerOpenedBPPackage"	"{s:player_name} ha encontrado <font color='#FF55FF'>{d:int_value} puntos de batalla</font>, que se reparten entre los jugadores Radiant."
"[english]GameEvent_PlayerOpenedBPPackage"	"{s:player_name} looted <font color='#FF55FF'> {d:int_value} battle points </font> split between Radiant players!"
"GameEvent_PlayerOpenedBPPackage_Dire"	"{s:player_name} ha encontrado <font color='#FF55FF'>{d:int_value} puntos de batalla</font>, que se reparten entre los jugadores Dire."
"[english]GameEvent_PlayerOpenedBPPackage_Dire"	"{s:player_name} looted <font color='#FF55FF'> {d:int_value} battle points </font> split between Dire players!"
"Morokai_Killed_Player"	"<font color='#27E100'>Mo'rokai {s:locstring_value}</font><panel class='CombatEventKillIcon'/>{s:player_name}"
"[english]Morokai_Killed_Player"	"<font color='#27E100'>{s:locstring_value} Mo'rokai</font><panel class='CombatEventKillIcon'/>{s:player_name}"
"Morokai_Killed_Player_Dire"	"<font color='#ff4d4d'>Mo'rokai {s:locstring_value}</font><panel class='CombatEventKillIcon'/>{s:player_name}"
"[english]Morokai_Killed_Player_Dire"	"<font color='#ff4d4d'>{s:locstring_value} Mo'rokai</font><panel class='CombatEventKillIcon'/>{s:player_name}"
"Player_Killed_Morokai"	"{s:player_name} <panel class='CombatEventKillIcon'/><font color='#27E100'>Mo'rokai {s:locstring_value}</font>"
"[english]Player_Killed_Morokai"	"{s:player_name}<panel class='CombatEventKillIcon'/><font color='#27E100'>{s:locstring_value} Mo'rokai</font>"
"Player_Killed_Morokai_Dire"	"{s:player_name} <panel class='CombatEventKillIcon'/><font color='#ff4d4d'>Mo'rokai {s:locstring_value}</font>"
"[english]Player_Killed_Morokai_Dire"	"{s:player_name}<panel class='CombatEventKillIcon'/><font color='#ff4d4d'>{s:locstring_value} Mo'rokai</font>"
"Morokai_Killed_NoPlayer"	"¡<panel class='CombatEventKillIcon'/>El <font color='#27E100'>Mo'rokai {s:locstring_value}</font> ha sido asesinado!"
"[english]Morokai_Killed_NoPlayer"	"<panel class='CombatEventKillIcon'/><font color='#27E100'>{s:locstring_value} Mo'rokai</font> was killed!"
"Morokai_Killed_NoPlayer_Dire"	"¡<panel class='CombatEventKillIcon'/>El <font color='#ff4d4d'>Mo'rokai {s:locstring_value}</font> ha sido asesinado!"
"[english]Morokai_Killed_NoPlayer_Dire"	"<panel class='CombatEventKillIcon'/><font color='#ff4d4d'>{s:locstring_value} Mo'rokai</font> was killed!"
"Morokai_EssenceMeter_Tooltip"	"Cuando tu medidor de esencia está lleno, puedes subir de nivel de tu Mo'rokai. Haz clic en el medidor para mostrar el cuadro de habilidades y elige un camino para Mo'rokai para que suba de nivel."
"[english]Morokai_EssenceMeter_Tooltip"	"When your essence meter is full you can level up your Mo'rokai. Click the meter to show the skill tree and pick a Mo'rokai path to level up."
"DOTA_Tooltip_Ability_item_travel_boots_morokai"	"Botas Mo'rokai con Estilo"
"[english]DOTA_Tooltip_Ability_item_travel_boots_morokai"	"Stylish Mo'rokai Boots"
"DOTA_Tooltip_Ability_item_platemail_morokai"	"Armadura Mo'rokai con Estilo"
"[english]DOTA_Tooltip_Ability_item_platemail_morokai"	"Trendy Mo'rokai Armor"
"DOTA_Tooltip_Ability_item_battle_points"	"125 puntos de batalla"
"[english]DOTA_Tooltip_Ability_item_battle_points"	"125 Battle Points"
"DOTA_Tooltip_Ability_item_battle_points_250"	"250 puntos de batalla"
"[english]DOTA_Tooltip_Ability_item_battle_points_250"	"250 Battle Points"
"DOTA_Tooltip_Ability_item_battle_points_500"	"500 puntos de batalla"
"[english]DOTA_Tooltip_Ability_item_battle_points_500"	"500 Battle Points"
"DOTA_Tooltip_Ability_item_battle_points_2000"	"2000 puntos de batalla"
"[english]DOTA_Tooltip_Ability_item_battle_points_2000"	"2000 Battle Points"
"DOTA_Tooltip_Ability_item_battle_points_5000"	"5000 puntos de batalla"
"[english]DOTA_Tooltip_Ability_item_battle_points_5000"	"5000 Battle Points"
"DOTA_Tooltip_modifier_spirit_gem"	"Esencia"
"[english]DOTA_Tooltip_modifier_spirit_gem"	"Essence"
"DOTA_Tooltip_modifier_spirit_gem_Description"	"La esencia recogida de esta unidad. Proporciona un mayor daño infligido cuando se mantienen grandes cantidades."
"[english]DOTA_Tooltip_modifier_spirit_gem_Description"	"This unit's collected essence. Provides increased outgoing damage when holding large amounts."
"DOTA_Tooltip_ability_jungle_spirit_summon_creeps"	"Guerreros Espirituales"
"[english]DOTA_Tooltip_ability_jungle_spirit_summon_creeps"	"Spirit Warriors"
"DOTA_Tooltip_ability_jungle_spirit_summon_creeps_Description"	"Lanza un proyectil al objetivo, lo daña y convoca a los Guerreros Espirituales a su alrededor."
"[english]DOTA_Tooltip_ability_jungle_spirit_summon_creeps_Description"	"Launches a projectile at the target, damaging it and summoning Spirit Warriors around it."
"DOTA_Tooltip_ability_jungle_spirit_summon_creeps_treant_level"	"NIVEL DE LOS GUERREROS ESPIRITUALES:"
"[english]DOTA_Tooltip_ability_jungle_spirit_summon_creeps_treant_level"	"SPIRIT WARRIOR LEVEL:"
"DOTA_Tooltip_ability_jungle_spirit_summon_creeps_projectile_damage"	"DAÑO DEL PROYECTIL:"
"[english]DOTA_Tooltip_ability_jungle_spirit_summon_creeps_projectile_damage"	"PROJECTILE DAMAGE:"
"DOTA_Tooltip_ability_special_bonus_unique_morokai_treant_level"	"Guerreros espirituales más fuertes"
"[english]DOTA_Tooltip_ability_special_bonus_unique_morokai_treant_level"	"Stronger Spirit Warriors"
"DOTA_Tooltip_ability_morokai_jungle_heal_beam"	"Conjuro Salvaje"
"[english]DOTA_Tooltip_ability_morokai_jungle_heal_beam"	"Wild Conjuration"
"DOTA_Tooltip_ability_morokai_jungle_heal_beam_Description"	"El Mo'rokai crea rayos giratorios que transforman los árboles en Guerreros Espirituales aliados."
"[english]DOTA_Tooltip_ability_morokai_jungle_heal_beam_Description"	"The Mo'rokai creates rotating beams that transform trees into allied Spirit Warriors."
"DOTA_Tooltip_ability_morokai_jungle_heal_beam_beam_duration"	"DURACIÓN:"
"[english]DOTA_Tooltip_ability_morokai_jungle_heal_beam_beam_duration"	"DURATION:"
"DOTA_Tooltip_ability_morokai_jungle_heal_beam_beam_count"	"RAYOS:"
"[english]DOTA_Tooltip_ability_morokai_jungle_heal_beam_beam_count"	"BEAMS:"
"DOTA_Tooltip_ability_morokai_jungle_heal_beam_beam_range"	"ALCANCE:"
"[english]DOTA_Tooltip_ability_morokai_jungle_heal_beam_beam_range"	"RANGE:"
"DOTA_Tooltip_ability_morokai_jungle_heal_beam_hp_per_second"	"CURACIÓN POR SEGUNDO:"
"[english]DOTA_Tooltip_ability_morokai_jungle_heal_beam_hp_per_second"	"HEAL PER SECOND:"
"DOTA_Tooltip_ability_special_bonus_unique_morokai_jungle_heal_beam_beam_heal"	"Bonificación de curación de Conjuro Salvaje"
"[english]DOTA_Tooltip_ability_special_bonus_unique_morokai_jungle_heal_beam_beam_heal"	"Wild Conjuration Bonus Healing"
"DOTA_Tooltip_ability_special_bonus_unique_morokai_jungle_heal_beam_beam_heal_Description"	"Los rayos de Conjuro Salvaje del Mo'rokai obtienen +20 de curación por segundo"
"[english]DOTA_Tooltip_ability_special_bonus_unique_morokai_jungle_heal_beam_beam_heal_Description"	"The Mo'rokai's Wild Conuration Beams gain +20 Heal per Second"
"DOTA_Tooltip_ability_special_bonus_unique_morokai_jungle_heal_beam_third_beam"	"Rayos extra de Conjuro Salvaje"
"[english]DOTA_Tooltip_ability_special_bonus_unique_morokai_jungle_heal_beam_third_beam"	"Wild Conjuration Extra Beams"
"DOTA_Tooltip_ability_special_bonus_unique_morokai_jungle_heal_beam_third_beam_Description"	"El Conjuro Salvaje del Mo'rokai obtiene 2 Haces Curativos adicionales"
"[english]DOTA_Tooltip_ability_special_bonus_unique_morokai_jungle_heal_beam_third_beam_Description"	"The Mo'rokai's Wild Conuration Gains 2 additional Heal Beams"
"DOTA_Tooltip_ability_jungle_spirit_river_rejuvenation"	"Rejuvenecimiento del agua de lluvia"
"[english]DOTA_Tooltip_ability_jungle_spirit_river_rejuvenation"	"Rainwater Rejuvenation"
"DOTA_Tooltip_ability_jungle_spirit_river_rejuvenation_Description"	"Otorga a los héroes vida y maná cuando están en el río o cerca de uno de sus santuarios."
"[english]DOTA_Tooltip_ability_jungle_spirit_river_rejuvenation_Description"	"Grants heroes health and mana when they are in the river or near one of their shrines."
"DOTA_Tooltip_ability_jungle_spirit_river_rejuvenation_health_restore"	"VIDA POR SEGUNDO:"
"[english]DOTA_Tooltip_ability_jungle_spirit_river_rejuvenation_health_restore"	"HEALTH PER SECOND:"
"DOTA_Tooltip_ability_jungle_spirit_river_rejuvenation_mana_restore"	"MANÁ POR SEGUNDO:"
"[english]DOTA_Tooltip_ability_jungle_spirit_river_rejuvenation_mana_restore"	"MANA PER SECOND:"
"DOTA_Tooltip_modifier_jungle_spirit_river_rejuvenation_regen"	"Rejuvenecimiento del agua de lluvia"
"[english]DOTA_Tooltip_modifier_jungle_spirit_river_rejuvenation_regen"	"Rainwater Rejuvenation"
"DOTA_Tooltip_modifier_jungle_spirit_river_rejuvenation_regen_Description"	"Esta unidad está regenerando vida y maná mientras está en el río o cerca de uno de sus santuarios."
"[english]DOTA_Tooltip_modifier_jungle_spirit_river_rejuvenation_regen_Description"	"This unit is regenerating health and mana while in the river or near one of its shrines."
"DOTA_Tooltip_modifier_jungle_spirit_river_rejuvenation_regen_health_restore"	"REGENERACIÓN DE VIDA:"
"[english]DOTA_Tooltip_modifier_jungle_spirit_river_rejuvenation_regen_health_restore"	"HEALTH REGEN:"
"DOTA_Tooltip_modifier_jungle_spirit_river_rejuvenation_regen_mana_restore"	"REGENERACIÓN DE MANÁ:"
"[english]DOTA_Tooltip_modifier_jungle_spirit_river_rejuvenation_regen_mana_restore"	"MANA REGEN:"
"DOTA_Tooltip_ability_item_bag_of_gold_caster_only"	"Saco de Oro"
"[english]DOTA_Tooltip_ability_item_bag_of_gold_caster_only"	"Bag of Gold"
"DOTA_Tooltip_ability_junglespirit_volcano_eruption"	"Erupción"
"[english]DOTA_Tooltip_ability_junglespirit_volcano_eruption"	"Eruption"
"DOTA_Tooltip_ability_junglespirit_volcano_eruption_Description"	"Envía una erupción hacia la posición enemiga, derriba y daña a las unidades afectadas."
"[english]DOTA_Tooltip_ability_junglespirit_volcano_eruption_Description"	"Sends up an eruption towards the enemy position, knocking back and damaging affected units."
"DOTA_Tooltip_ability_junglespirit_volcano_eruption_split_radius"	"ÁREA DE EFECTO DE LA EXPLOSIÓN:"
"[english]DOTA_Tooltip_ability_junglespirit_volcano_eruption_split_radius"	"EXPLOSION AOE:"
"DOTA_Tooltip_ability_junglespirit_volcano_eruption_flight_time"	"RETRASO:"
"[english]DOTA_Tooltip_ability_junglespirit_volcano_eruption_flight_time"	"DELAY:"
"DOTA_Tooltip_ability_junglespirit_volcano_eruption_damage"	"DAÑO:"
"[english]DOTA_Tooltip_ability_junglespirit_volcano_eruption_damage"	"DAMAGE:"
"DOTA_Tooltip_ability_special_bonus_unique_jungle_spirit_volcano_multitarget"	"Multiobjetivo de Erupción"
"[english]DOTA_Tooltip_ability_special_bonus_unique_jungle_spirit_volcano_multitarget"	"Eruption Multitarget"
"DOTA_Tooltip_ability_special_bonus_unique_jungle_spirit_volcano_multitarget_Description"	"Erupción de Mo'rokai se dirige a un enemigo adicional con cada lanzamiento."
"[english]DOTA_Tooltip_ability_special_bonus_unique_jungle_spirit_volcano_multitarget_Description"	"The Mo'rokai's Eruption targets an additional enemy with each cast."
"DOTA_Tooltip_ability_special_bonus_unique_jungle_spirit_volcano_damage_bonus"	"Daño de bonificación de Erupción"
"[english]DOTA_Tooltip_ability_special_bonus_unique_jungle_spirit_volcano_damage_bonus"	"Eruption Bonus Damage"
"DOTA_Tooltip_ability_special_bonus_unique_jungle_spirit_volcano_damage_bonus_Description"	"Erupción de Mo'rokai gana 500 puntos de daño adicional."
"[english]DOTA_Tooltip_ability_special_bonus_unique_jungle_spirit_volcano_damage_bonus_Description"	"The Mo'rokai's Eruption gains 500 bonus damage."
"DOTA_Tooltip_ability_special_bonus_unique_jungle_spirit_volcano_splinter"	"Esquirla de Erupción"
"[english]DOTA_Tooltip_ability_special_bonus_unique_jungle_spirit_volcano_splinter"	"Eruption Splinter"
"DOTA_Tooltip_ability_special_bonus_unique_jungle_spirit_volcano_splinter_Description"	"Erupción de Mo'rokai se divide en 6 piedras adicionales alrededor del objetivo."
"[english]DOTA_Tooltip_ability_special_bonus_unique_jungle_spirit_volcano_splinter_Description"	"The Mo'rokai's Eruption splits into 6 additional stones around the target."
"DOTA_Tooltip_ability_jungle_spirit_storm_cyclone"	"Ciclón"
"[english]DOTA_Tooltip_ability_jungle_spirit_storm_cyclone"	"Cyclone"
"DOTA_Tooltip_ability_jungle_spirit_storm_cyclone_Description"	"Crea una gran cantidad de ciclones que aturden y desorientan a los enemigos, infligiendo daño cada segundo."
"[english]DOTA_Tooltip_ability_jungle_spirit_storm_cyclone_Description"	"Creates a slew of cyclones that stun and disorient enemies, dealing damage every second."
"DOTA_Tooltip_ability_jungle_spirit_storm_cyclone_projectile_distance"	"DISTANCIA DE LANZAMIENTO:"
"[english]DOTA_Tooltip_ability_jungle_spirit_storm_cyclone_projectile_distance"	"CAST DISTANCE:"
"DOTA_Tooltip_ability_jungle_spirit_storm_cyclone_projectile_amount"	"CICLONES:"
"[english]DOTA_Tooltip_ability_jungle_spirit_storm_cyclone_projectile_amount"	"CYCLONES:"
"DOTA_Tooltip_ability_jungle_spirit_storm_cyclone_debuff_duration"	"DURACIÓN DEL ATURDIMIENTO:"
"[english]DOTA_Tooltip_ability_jungle_spirit_storm_cyclone_debuff_duration"	"STUN DURATION:"
"DOTA_Tooltip_ability_jungle_spirit_storm_cyclone_cyclone_damage"	"DAÑO:"
"[english]DOTA_Tooltip_ability_jungle_spirit_storm_cyclone_cyclone_damage"	"DAMAGE"
"DOTA_Tooltip_ability_special_bonus_unique_jungle_spirit_storm_cyclone_damage"	"Daño adicional por Ciclón"
"[english]DOTA_Tooltip_ability_special_bonus_unique_jungle_spirit_storm_cyclone_damage"	"Cyclone Bonus Damage"
"DOTA_Tooltip_ability_special_bonus_unique_jungle_spirit_storm_cyclone_damage_Description"	"Ciclón de los Mo'rokai causa +50 de daño por segundo."
"[english]DOTA_Tooltip_ability_special_bonus_unique_jungle_spirit_storm_cyclone_damage_Description"	"The Mo'rokai's Cyclones deal +50 damage per second."
"DOTA_Tooltip_ability_special_bonus_unique_jungle_spirit_storm_cyclone_debuff_duration"	"Duración del efecto de Ciclón"
"[english]DOTA_Tooltip_ability_special_bonus_unique_jungle_spirit_storm_cyclone_debuff_duration"	"Cyclone Debuff Duration"
"DOTA_Tooltip_ability_special_bonus_unique_jungle_spirit_storm_cyclone_debuff_duration_Description"	"Los Ciclones de Mo'rokai ganan 2 segundos de aturdimiento al impactar."
"[english]DOTA_Tooltip_ability_special_bonus_unique_jungle_spirit_storm_cyclone_debuff_duration_Description"	"The Mo'rokai's Cyclones gain 2 seconds of stun on impact."
"DOTA_Tooltip_ability_special_bonus_unique_jungle_spirit_storm_cyclone_projectiles"	"Ciclones de Ciclón Adicional."
"[english]DOTA_Tooltip_ability_special_bonus_unique_jungle_spirit_storm_cyclone_projectiles"	"Cyclone Extra Cyclones."
"DOTA_Tooltip_ability_special_bonus_unique_jungle_spirit_storm_cyclone_projectiles_Description"	"Los ciclones de Mo'rokai +6 ciclones creados."
"[english]DOTA_Tooltip_ability_special_bonus_unique_jungle_spirit_storm_cyclone_projectiles_Description"	"The Mo'rokai's Cyclones +6 cyclones created."
"HERO_BUTTONCATEGORY"	"cosas"
"[english]HERO_BUTTONCATEGORY"	"stuff"
"DOTA_Tooltip_ability_jungle_spirit_volcano_damage_block"	"Escudo de Obsidiana"
"[english]DOTA_Tooltip_ability_jungle_spirit_volcano_damage_block"	"Obsidian Shield"
"DOTA_Tooltip_ability_jungle_spirit_volcano_damage_block_Description"	"Proporciona la posibilidad de bloquear un porcentaje del daño físico recibido."
"[english]DOTA_Tooltip_ability_jungle_spirit_volcano_damage_block_Description"	"Provides a chance to block a percent of incoming physical damage."
"DOTA_Tooltip_ability_jungle_spirit_volcano_damage_block_block_chance"	"PROBABILIDAD DE BLOQUEO:"
"[english]DOTA_Tooltip_ability_jungle_spirit_volcano_damage_block_block_chance"	"BLOCK CHANCE:"
"DOTA_Tooltip_ability_jungle_spirit_volcano_damage_block_damage_reduction"	"REDUCCIÓN DE DAÑO:"
"[english]DOTA_Tooltip_ability_jungle_spirit_volcano_damage_block_damage_reduction"	"DAMAGE REDUCTION:"
"DOTA_Tooltip_modifier_jungle_spirit_volcano_damage_block"	"Escudo de Obsidiana"
"[english]DOTA_Tooltip_modifier_jungle_spirit_volcano_damage_block"	"Obsidian Shield"
"DOTA_Tooltip_modifier_jungle_spirit_volcano_damage_block_Description"	"El Mo'rokai da la posibilidad de bloquear el 25 % del daño físico recibido."
"[english]DOTA_Tooltip_modifier_jungle_spirit_volcano_damage_block_Description"	"The Mo'rokai is providing a chance to block 25% of incoming physical damage."
"DOTA_Tooltip_modifier_jungle_spirit_volcano_damage_block_block_chance"	"PROBABILIDAD DE BLOQUEO:"
"[english]DOTA_Tooltip_modifier_jungle_spirit_volcano_damage_block_block_chance"	"BLOCK CHANCE:"
"DOTA_Tooltip_modifier_jungle_spirit_volcano_damage_block_damage_reduction"	"REDUCCIÓN DE DAÑO:"
"[english]DOTA_Tooltip_modifier_jungle_spirit_volcano_damage_block_damage_reduction"	"DAMAGE REDUCTION:"
"DOTA_Tooltip_ability_jungle_spirit_storm_multicast"	"Lanzamiento de Tormenta"
"[english]DOTA_Tooltip_ability_jungle_spirit_storm_multicast"	"Stormcasting"
"DOTA_Tooltip_ability_jungle_spirit_storm_multicast_Description"	"Ofrece la posibilidad de lanzar un hechizo dirigido adicional."
"[english]DOTA_Tooltip_ability_jungle_spirit_storm_multicast_Description"	"Provides a chance to cast an additional targeted spell."
"DOTA_Tooltip_ability_jungle_spirit_storm_multicast_multicast_chance"	"PROBABILIDAD DE LANZAMIENTO MÚLTIPLE:"
"[english]DOTA_Tooltip_ability_jungle_spirit_storm_multicast_multicast_chance"	"MULTICAST CHANCE:"
"DOTA_Tooltip_modifier_jungle_spirit_storm_multicast"	"Lanzamiento de Tormenta"
"[english]DOTA_Tooltip_modifier_jungle_spirit_storm_multicast"	"Stormcasting"
"DOTA_Tooltip_modifier_jungle_spirit_storm_multicast_Description"	"El Mo'rokai ofrece la posibilidad de lanzar un hechizo dirigido adicional."
"[english]DOTA_Tooltip_modifier_jungle_spirit_storm_multicast_Description"	"The Mo'rokai is providing a chance to cast an additional targeted spell."
"DOTA_Tooltip_modifier_jungle_spirit_storm_multicast_multicast_chance"	"PROBABILIDAD DE LANZAMIENTO MÚLTIPLE:"
"[english]DOTA_Tooltip_modifier_jungle_spirit_storm_multicast_multicast_chance"	"MULTICAST CHANCE:"
"DOTA_Tooltip_ability_jungle_spirit_jungle_building_regeneration"	"Estructuras Vivientes"
"[english]DOTA_Tooltip_ability_jungle_spirit_jungle_building_regeneration"	"Living Structures"
"DOTA_Tooltip_ability_jungle_spirit_jungle_building_regeneration_Description"	"Proporciona regeneración pasiva a todas las estructuras aliadas."
"[english]DOTA_Tooltip_ability_jungle_spirit_jungle_building_regeneration_Description"	"Provides passive regeneration to all allied structures."
"DOTA_Tooltip_ability_jungle_spirit_jungle_building_regeneration_regeneration"	"REGENERACIÓN:"
"[english]DOTA_Tooltip_ability_jungle_spirit_jungle_building_regeneration_regeneration"	"REGENERATION:"
"DOTA_Tooltip_modifier_jungle_spirit_jungle_building_regeneration"	"Estructuras Vivientes"
"[english]DOTA_Tooltip_modifier_jungle_spirit_jungle_building_regeneration"	"Living Structures"
"DOTA_Tooltip_modifier_jungle_spirit_jungle_building_regeneration_Description"	"El Mo'rokai está regenerando estructuras."
"[english]DOTA_Tooltip_modifier_jungle_spirit_jungle_building_regeneration_Description"	"The Mo'rokai is regenerating buildings."
"DOTA_Tooltip_modifier_jungle_spirit_jungle_building_regeneration_regeneration"	"REGENERACIÓN:"
"[english]DOTA_Tooltip_modifier_jungle_spirit_jungle_building_regeneration_regeneration"	"REGENERATION:"
"DOTA_Tooltip_ability_jungle_spirit_jungle_lumber_lock"	"Árboles Traicioneros"
"[english]DOTA_Tooltip_ability_jungle_spirit_jungle_lumber_lock"	"Treacherous Trees"
"DOTA_Tooltip_ability_jungle_spirit_jungle_lumber_lock_Description"	"Algunos de tus ataques crearán una fila de árboles detrás del enemigo."
"[english]DOTA_Tooltip_ability_jungle_spirit_jungle_lumber_lock_Description"	"Provides a chance to create a row of trees behind an enemy on each attack."
"DOTA_Tooltip_ability_jungle_spirit_jungle_lumber_lock_sprout_chance"	"PROBABILIDAD:"
"[english]DOTA_Tooltip_ability_jungle_spirit_jungle_lumber_lock_sprout_chance"	"CHANCE:"
"DOTA_Tooltip_ability_jungle_spirit_jungle_lumber_lock_duration"	"DURACIÓN:"
"[english]DOTA_Tooltip_ability_jungle_spirit_jungle_lumber_lock_duration"	"DURATION:"
"DOTA_Tooltip_modifier_jungle_spirit_jungle_lumber_lock"	"Árboles Traicioneros"
"[english]DOTA_Tooltip_modifier_jungle_spirit_jungle_lumber_lock"	"Treacherous Trees"
"DOTA_Tooltip_modifier_jungle_spirit_jungle_lumber_lock_Description"	"Algunos de tus ataques crearán una fila de árboles detrás del enemigo."
"[english]DOTA_Tooltip_modifier_jungle_spirit_jungle_lumber_lock_Description"	"Provides a chance to create a row of trees behind an enemy on each attack."
"DOTA_Tooltip_modifier_jungle_spirit_jungle_lumber_lock_sprout_chance"	"PROBABILIDAD:"
"[english]DOTA_Tooltip_modifier_jungle_spirit_jungle_lumber_lock_sprout_chance"	"CHANCE:"
"DOTA_Tooltip_modifier_jungle_spirit_jungle_lumber_lock_duration"	"DURACIÓN:"
"[english]DOTA_Tooltip_modifier_jungle_spirit_jungle_lumber_lock_duration"	"DURATION:"
"DOTA_Tooltip_ability_jungle_spirit_volcano_fire_strike"	"Escisión Volcánica"
"[english]DOTA_Tooltip_ability_jungle_spirit_volcano_fire_strike"	"Volcanic Cleave"
"DOTA_Tooltip_ability_jungle_spirit_volcano_fire_strike_Description"	"Los héroes cuerpo a cuerpo tienen la posibilidad de golpear objetivos en un área de efecto después de un ataque."
"[english]DOTA_Tooltip_ability_jungle_spirit_volcano_fire_strike_Description"	"Melee heroes have a chance to strike targets in an AoE after an attack."
"DOTA_Tooltip_ability_jungle_spirit_volcano_fire_strike_strike_chance"	"PROBABILIDAD DE ATAQUE:"
"[english]DOTA_Tooltip_ability_jungle_spirit_volcano_fire_strike_strike_chance"	"ATTACK CHANCE:"
"DOTA_Tooltip_ability_jungle_spirit_volcano_fire_strike_radius"	"RADIO:"
"[english]DOTA_Tooltip_ability_jungle_spirit_volcano_fire_strike_radius"	"RADIUS:"
"DOTA_Tooltip_modifier_jungle_spirit_volcano_fire_strike"	"Escisión Volcánica"
"[english]DOTA_Tooltip_modifier_jungle_spirit_volcano_fire_strike"	"Volcanic Cleave"
"DOTA_Tooltip_modifier_jungle_spirit_volcano_fire_strike_Description"	"El Mo'rokai aporta una oportunidad para atacar a unidades en un área de efecto después de un ataque."
"[english]DOTA_Tooltip_modifier_jungle_spirit_volcano_fire_strike_Description"	"The Mo'rokai is providing a chance to strike targets in an AoE after an attack."
"DOTA_Tooltip_modifier_jungle_spirit_volcano_fire_strike_strike_chance"	"PROBABILIDAD DE ATAQUE:"
"[english]DOTA_Tooltip_modifier_jungle_spirit_volcano_fire_strike_strike_chance"	"ATTACK CHANCE:"
"DOTA_Tooltip_modifier_jungle_spirit_volcano_fire_strike_radius"	"RADIO:"
"[english]DOTA_Tooltip_modifier_jungle_spirit_volcano_fire_strike_radius"	"RADIUS:"
"DOTA_Tooltip_Ability_jungle_spirit_melee_smash"	"Ataque cuerpo a cuerpo"
"[english]DOTA_Tooltip_Ability_jungle_spirit_melee_smash"	"Melee Attack"
"DOTA_Tooltip_Ability_jungle_spirit_melee_smash_Description"	"El Mo'rokai golpea el suelo, dañando e impactando a los enemigos en un área de efecto."
"[english]DOTA_Tooltip_Ability_jungle_spirit_melee_smash_Description"	"The Mo'rokai smashes the ground, damaging and stunning enemies in an AoE."
"DOTA_Tooltip_Ability_jungle_spirit_melee_smash_impact_radius"	"RADIO:"
"[english]DOTA_Tooltip_Ability_jungle_spirit_melee_smash_impact_radius"	"RADIUS:"
"DOTA_Tooltip_Ability_jungle_spirit_melee_smash_impact_stun_duration"	"DURACIÓN DEL ATURDIMIENTO:"
"[english]DOTA_Tooltip_Ability_jungle_spirit_melee_smash_impact_stun_duration"	"STUN DURATION:"
"DOTA_Tooltip_Ability_jungle_spirit_range_attack"	"Ataque a distancia"
"[english]DOTA_Tooltip_Ability_jungle_spirit_range_attack"	"Range Attack"
"DOTA_Tooltip_Ability_jungle_spirit_range_attack_Description"	"El Mo'rokai dispara una bola de energía que sigue y daña a un enemigo."
"[english]DOTA_Tooltip_Ability_jungle_spirit_range_attack_Description"	"The Mo'rokai fires a ball of energy that tracks and damages an enemy."
"DOTA_Tooltip_Ability_special_bonus_unique_jungle_spirit_melee_stun_duration"	"Duración del aturdimiento del ataque cuerpo a cuerpo del Mo'rokai"
"[english]DOTA_Tooltip_Ability_special_bonus_unique_jungle_spirit_melee_stun_duration"	"Mo'rokai Melee Attack Stun Duration"
"DOTA_Tooltip_Ability_special_bonus_unique_jungle_spirit_melee_stun_duration_Description"	"Los ataques cuerpo a cuerpo de Mo'rokai ganan un segundo en la duración del aturdimiento."
"[english]DOTA_Tooltip_Ability_special_bonus_unique_jungle_spirit_melee_stun_duration_Description"	"The Mo'rokai's Melee Attacks gain 1 second stun duration."
"DOTA_Tooltip_Ability_special_bonus_unique_morokai_jungle_heal_beam_treant_level"	"Guerreros espirituales Mo'rokai más fuertes"
"[english]DOTA_Tooltip_Ability_special_bonus_unique_morokai_jungle_heal_beam_treant_level"	"Mo'rokai Stronger Spirit Warriors"
"DOTA_Tooltip_Ability_special_bonus_unique_morokai_jungle_heal_beam_treant_level_Description"	"Conjuro Salvaje del Mo'rokai invoca a los Guardianes espirituales."
"[english]DOTA_Tooltip_Ability_special_bonus_unique_morokai_jungle_heal_beam_treant_level_Description"	"The Mo'rokai's Wild Conjuration summons Spirit Guardians."
"DOTA_Tooltip_Ability_special_bonus_unique_morokai_range_attack_aoe_damage"	"Explosión de ataque a distancia de Mo'rokai"
"[english]DOTA_Tooltip_Ability_special_bonus_unique_morokai_range_attack_aoe_damage"	"Mo'rokai Ranged Attack Explosion"
"DOTA_Tooltip_Ability_special_bonus_unique_morokai_range_attack_aoe_damage_Description"	"El ataque a distancia de Mo'rokai estalla, produciendo daño en un 250 de área de efecto."
"[english]DOTA_Tooltip_Ability_special_bonus_unique_morokai_range_attack_aoe_damage_Description"	"The Mo'rokai's Ranged Attack Explodes, dealing damage in a 250 Area of Effect."
"DOTA_Tooltip_Ability_special_bonus_unique_jungle_spirit_movement_speed"	"Velocidad de movimiento del Mo'rokai"
"[english]DOTA_Tooltip_Ability_special_bonus_unique_jungle_spirit_movement_speed"	"Mo'rokai Movement Speed"
"DOTA_Tooltip_Ability_special_bonus_unique_jungle_spirit_movement_speed_Description"	"El Mo'rokai obtiene 50 de velocidad de movimiento."
"[english]DOTA_Tooltip_Ability_special_bonus_unique_jungle_spirit_movement_speed_Description"	"The Mo'rokai gains 50 movement speed."
"DOTA_Tooltip_Ability_special_bonus_unique_jungle_spirit_spell_lifesteal"	"Robo de vida por hechizo del Mo'rokai"
"[english]DOTA_Tooltip_Ability_special_bonus_unique_jungle_spirit_spell_lifesteal"	"Mo'rokai Spell Lifesteal"
"DOTA_Tooltip_Ability_special_bonus_unique_jungle_spirit_spell_lifesteal_Description"	"El Mo'rokai se cura un 30 % de todo el daño infligido por los hechizos."
"[english]DOTA_Tooltip_Ability_special_bonus_unique_jungle_spirit_spell_lifesteal_Description"	"The Mo'rokai heals 30% of all damage dealt from spells."
"DOTA_Tooltip_Ability_special_bonus_unique_jungle_spirit_evasion"	"Evasión del Mo'rokai"
"[english]DOTA_Tooltip_Ability_special_bonus_unique_jungle_spirit_evasion"	"Mo'rokai Evasion"
"DOTA_Tooltip_Ability_special_bonus_unique_jungle_spirit_evasion_Description"	"El Mo'rokai tiene un 30 % de probabilidad de evadir los ataques que recibe."
"[english]DOTA_Tooltip_Ability_special_bonus_unique_jungle_spirit_evasion_Description"	"The Mo'rokai has a 30% chance to evade incoming attacks."
"DOTA_Tooltip_Ability_special_bonus_unique_jungle_spirit_bonus_health"	"Vida del Mo'rokai"
"[english]DOTA_Tooltip_Ability_special_bonus_unique_jungle_spirit_bonus_health"	"Mo'rokai Health"
"DOTA_Tooltip_Ability_special_bonus_unique_jungle_spirit_bonus_health_Description"	"El Mo'rokai obtiene 800 de vida."
"[english]DOTA_Tooltip_Ability_special_bonus_unique_jungle_spirit_bonus_health_Description"	"The Mo'rokai gains 800 Health."
"DOTA_Tooltip_Ability_special_bonus_unique_jungle_spirit_cooldown_reduction"	"Reducción del tiempo de recarga del Mo'rokai"
"[english]DOTA_Tooltip_Ability_special_bonus_unique_jungle_spirit_cooldown_reduction"	"Mo'rokai Cooldown Reduction"
"DOTA_Tooltip_Ability_special_bonus_unique_jungle_spirit_cooldown_reduction_Description"	"El Mo'rokai tiene un 15 % de reducción del tiempo de recarga en sus ataques y hechizos."
"[english]DOTA_Tooltip_Ability_special_bonus_unique_jungle_spirit_cooldown_reduction_Description"	"The Mo'rokai has 15% cooldown reduction on its attacks and spells."
"DOTA_Tooltip_Ability_special_bonus_unique_jungle_spirit_magic_resistance"	"Resistencia mágica del Mo'rokai"
"[english]DOTA_Tooltip_Ability_special_bonus_unique_jungle_spirit_magic_resistance"	"Mo'rokai Magic Resistance"
"DOTA_Tooltip_Ability_special_bonus_unique_jungle_spirit_magic_resistance_Description"	"El Mo'rokai recibe un 15 % menos de daño de los ataques mágicos."
"[english]DOTA_Tooltip_Ability_special_bonus_unique_jungle_spirit_magic_resistance_Description"	"The Mo'rokai takes 15% less damage from Magic attacks."
"DOTA_Tooltip_Ability_special_bonus_unique_jungle_spirit_spell_amplify"	"Amplificación de hechizo del Mo'rokai"
"[english]DOTA_Tooltip_Ability_special_bonus_unique_jungle_spirit_spell_amplify"	"Mo'rokai Spell Amplification"
"DOTA_Tooltip_Ability_special_bonus_unique_jungle_spirit_spell_amplify_Description"	"Las habilidades del Mo'rokai causan un 20 % más de daño."
"[english]DOTA_Tooltip_Ability_special_bonus_unique_jungle_spirit_spell_amplify_Description"	"The Mo'rokai's abilities deal 20% more damage."
"DOTA_Tooltip_Ability_special_bonus_unique_jungle_spirit_attack_damage"	"Daño del Mo'rokai"
"[english]DOTA_Tooltip_Ability_special_bonus_unique_jungle_spirit_attack_damage"	"Mo'rokai Damage"
"DOTA_Tooltip_Ability_special_bonus_unique_jungle_spirit_attack_damage_Description"	"Los ataques cuerpo a cuerpo y a distancia del Mo'rokai infligen +40 de daño."
"[english]DOTA_Tooltip_Ability_special_bonus_unique_jungle_spirit_attack_damage_Description"	"The Mo'rokai's Melee and Range attacks deal +40 damage."
"DOTA_Tooltip_Ability_special_bonus_unique_jungle_spirit_health_regen"	"Regeneración de vida del Mo'rokai"
"[english]DOTA_Tooltip_Ability_special_bonus_unique_jungle_spirit_health_regen"	"Mo'rokai Health Regen"
"DOTA_Tooltip_Ability_special_bonus_unique_jungle_spirit_health_regen_Description"	"El Mo'rokai regenera 12 de vida por segundo."
"[english]DOTA_Tooltip_Ability_special_bonus_unique_jungle_spirit_health_regen_Description"	"The Mo'rokai regenerates 12 health per second."
"DOTA_Tooltip_Ability_special_bonus_unique_jungle_spirit_bonus_armor"	"Armadura del Mo'rokai"
"[english]DOTA_Tooltip_Ability_special_bonus_unique_jungle_spirit_bonus_armor"	"Mo'rokai Armor"
"DOTA_Tooltip_Ability_special_bonus_unique_jungle_spirit_bonus_armor_Description"	"El Mo'rokai obtiene 20 de armadura."
"[english]DOTA_Tooltip_Ability_special_bonus_unique_jungle_spirit_bonus_armor_Description"	"The Mo'rokai gains 20 armor."
"jungle_spirits_game_info_brief_description"	"Los guardianes ancestrales se levantan, pero necesitan un tributo para recobrar fuerzas. Recoge esencia y úsala para guiar el crecimiento de tu Mo'rokai."
"[english]jungle_spirits_game_info_brief_description"	"The ancient guardians rise, but they require tribute to regain strength. Collect essence and use it to guide your Mo'rokai's growth."
"jungle_game_info_desc_group_1"	"Recoge la esencia de los creeps y enemigos abatidos; mas ve con cuidado, pues dejarás caer una parte de tu esencia si mueres."
"[english]jungle_game_info_desc_group_1"	"Collect essence from fallen creeps and enemies, but tread lightly—you'll drop a portion of your essence if you die."
"jungle_game_info_desc_group_2"	"Reúne suficiente esencia para ofrecer un tributo a tu Mo'rokai. Sube de nivel sus habilidades arcanas para que te ayude a vencer."
"[english]jungle_game_info_desc_group_2"	"Gather enough essence to offer tribute to your Mo'rokai. Level up the Mo'rokai's arcane ability paths to aid your strategy."
"jungle_game_info_desc_group_3"	"Los Mo'rokai tienen voluntad propia. Ayuda al tuyo en su avance para aumentar su velocidad y tus opciones de victoria."
"[english]jungle_game_info_desc_group_3"	"The Mo'rokai have minds of their own. Assist your Mo'rokai when it marches to increase its speed and your odds of victory."
"jungle_game_info_ok"	"Aceptar"
"[english]jungle_game_info_ok"	"Ok"
"dota_game_end_victory_title_radiant"	"El Radiant Mo'rokai reina"
"[english]dota_game_end_victory_title_radiant"	"The Radiant Mo'rokai Reigns"
"dota_game_end_victory_title_dire"	"El Dire Mo'rokai reina"
"[english]dota_game_end_victory_title_dire"	"The Dire Mo'rokai Reigns"
"top_lane"	"superior"
"[english]top_lane"	"top"
"middle_lane"	"central"
"[english]middle_lane"	"middle"
"bottom_lane"	"inferior"
"[english]bottom_lane"	"bottom"
}
}
